# Level: ATIC=1,FIRST_FLOOR=2,GROUND=3,BASEMENT=4,CAVERNS=5
# Type: STD=1,EDGE=2,CAVERN=3,ATIC=4,DBLDOOR=5
# Color: BLACK=0,BLUE=1,RED=2,MAGENTA=3,GREEN=4,CYAN=5,YELLOW=6,WHITE=7
# Scale: FULL=1,HORIZ=2,VERT=3
#
# Ground rooms
# ID, Level, Type, Color, Scale, ID(left, right, top, bottom)
# I  L  T  C  S  Links
001, 3, 1, 6, 2, 000, 002, 000, 000
002, 3, 1, 3, 1, 001, 003, 000, 007
003, 3, 1, 2, 2, 002, 004, 000, 000
004, 3, 1, 3, 2, 003, 005, 000, 000
005, 3, 1, 4, 2, 004, 006, 000, 000
006, 3, 1, 5, 1, 005, 000, 000, 008
007, 3, 1, 4, 3, 000, 000, 002, 009
008, 3, 1, 6, 3, 000, 000, 006, 013
009, 3, 1, 5, 3, 000, 010, 007, 015
010, 3, 1, 6, 1, 009, 011, 000, 000
011, 3, 1, 5, 1, 010, 012, 000, 000
012, 3, 2, 5, 4, 011, 013, 000, 016
# TODO: Room 13 bottom goes to first floor
013, 3, 1, 4, 2, 012, 014, 008, 000
014, 3, 2, 3, 1, 013, 000, 000, 018
015, 3, 1, 6, 3, 000, 000, 009, 019
016, 3, 1, 6, 3, 000, 017, 012, 022
017, 3, 1, 7, 2, 016, 018, 000, 000
018, 3, 1, 2, 1, 017, 999, 014, 024
019, 3, 1, 7, 3, 000, 020, 015, 025
020, 3, 1, 4, 1, 019, 021, 000, 000
021, 3, 1, 3, 1, 020, 022, 000, 000
022, 3, 2, 7, 1, 021, 023, 016, 000
# TODO: Room 23 top goes to basement
023, 3, 1, 6, 2, 022, 024, 000, 026
024, 3, 2, 5, 1, 023, 000, 018, 000
025, 3, 1, 6, 3, 000, 000, 019, 027
026, 3, 1, 4, 3, 000, 000, 023, 031
027, 3, 1, 5, 1, 000, 028, 025, 032
028, 3, 1, 4, 2, 027, 029, 000, 000
029, 3, 1, 3, 2, 028, 030, 000, 000
030, 3, 1, 2, 2, 029, 031, 000, 000
031, 3, 1, 3, 1, 030, 000, 026, 000
032, 3, 1, 2, 3, 000, 000, 027, 033
# Room 33 is a double door room (special) and also it goes down to caverns
033, 3, 5, 3, 1, 000, 000, 000, 032