# Level: ATIC=1,FIRST_FLOOR=2,GROUND=3,BASEMENT=4,CAVERNS=5
# Type: STD=1,EDGE=2,CAVERN=3,ATIC=4
# Color: BLACK=0,BLUE=1,RED=2,MAGENTA=3,GREEN=4,CYAN=5,YELLOW=6,WHITE=7
# Scale: FULL=1,HORIZ=2,VERT=3,EDGE=4
#
# Ground rooms
# ID, Level, Type, Color, Scale, ID(left, right, top, bottom)
# I  L  T  C  S  Links
#
001, 3, 1, 6, 2, 000, 002, 000, 000
002, 3, 1, 3, 1, 001, 003, 000, 007
003, 3, 1, 2, 2, 002, 004, 000, 000
004, 3, 1, 3, 2, 003, 005, 000, 000
005, 3, 1, 4, 2, 004, 006, 000, 000
006, 3, 1, 5, 1, 005, 000, 000, 008
007, 3, 1, 4, 3, 000, 000, 002, 009
008, 3, 1, 6, 3, 000, 000, 006, 013
009, 3, 1, 5, 3, 000, 010, 007, 015
010, 3, 1, 6, 1, 009, 011, 000, 000
011, 3, 1, 5, 1, 010, 012, 000, 000
012, 3, 2, 5, 4, 011, 013, 000, 016
# TODO: Room 13 bottom goes to first floor
013, 3, 1, 4, 2, 012, 014, 008, 000
014, 3, 2, 3, 1, 013, 000, 000, 018
015, 3
016, 3
017, 3
018, 3
019, 3
020, 3
021, 3
022, 3
023, 3
024, 3
025, 3
026, 3
027, 3
028, 3
029, 3
030, 3
031, 3
032, 3
033, 3